maze = [2 1 1 1 1 1 1 1 1 1 1 1 1 1 1 1;
        1 0 1 0 0 0 0 0 0 0 0 0 0 0 0 0;
        1 0 1 1 1 1 1 1 1 1 1 1 1 1 1 1;
        1 0 1 0 0 0 0 1 0 1 0 0 0 0 1 1;
        1 0 1 0 0 0 0 1 0 1 0 0 0 0 0 1;
        1 1 1 0 0 0 0 1 0 1 0 1 1 0 0 1;
        1 0 1 1 1 1 1 1 0 1 0 1 1 0 0 1;
        1 0 0 0 0 0 0 1 0 1 0 0 1 0 0 1;
        1 1 1 1 1 1 1 1 0 1 1 1 1 0 0 3;
        1 0 0 0 0 0 0 0 0 1 0 0 0 0 0 0]

could solve by q learining in 10,000 iterations (episodic task)

